FXXFFFXFFF
FFXFFXXFFF
XFFFXXFFXF
FFFXFFFXXF
XFFFFXFFFF
XXXFFFFFXX
XFFFFXXFFX
FFFFXXFFFF
XXFFXFXFFF
FFFFFFFFFP