FFXFFFFFXX
FFXFFXXFFX
FFFFXXFFXX
FFFFXXFFFX
XXXFFXXXFF
FFXFFXXFFX
FFFFXXFFXX
XXXFFFFXFF
XFXFFFXFFF
XFXFFFXFFF